+-|*
#
2 2
+--+-----+--+-----+-----+-----+--------+-----------------+--------------+-----+--------+--+--------+--------------+--------+--------------------------+
|  |     |  |     |     |     |        |                 |              |     |        |  |        |              |        |                          |
|  +  +  +  |  |  +---  |  +--+  +--+  |  +-----+-----+  |  +---------  +  +  +--+  +  +  +  +--+  +  +--+--+--+  +  +  +  +  +--+--+--+  +  +--+--+  |
|     |     |  |        |     |     |  |  |     |        |  |           |  |  |     |  |  |  |     |           |  |  |  |     |     |     |     |     |
+--+--+--+  |  |  +  ---+--+  |  +--+  |  |  *--+  +--+--+  |  ---+  +--+  +  +  +--+  +  +  +--+--+--+--+--+  +  +  +--+--+--+  +  +  +--+--+--+  +--+
|     |     |  |  |        |  |  |     |  |     |     |     |     |        |  |     |  |           |           |  |        |     |  |  |           |  |
|  +--+  +--+  +--+-----+  +  +--+  +--+  +--+  +--+  +  +--+--+  +--+  +--+  +--+  +  +  +  +--+  +--+--+--+  +  +--+--+  +  +--+--+  +  +--+--+--+  |
|           |     |     |  |           |     |     |  |        |     |     |     |  |     |     |        |     |     |        |     |  |        |     |
|  +--+--+--+--+  +--+  |  +  +--+  +  |  +--+--+  +  +  +--+--+--+  +--+--+--+  +  +--+--+--+  +--+--+  +  +  +--+  +  +--+--+  +  +  +--+--+  +  +--+
|  |           |  |     |     |     |     |     |     |     |     |  |     |     |  |           |     |  |  |     |     |        |     |     |     |  |
|  +--+--+--+  +  |  +--+--+--+  +--+--+  +  +  +--+--+--+  +  +--+  |  +  +  +--+--+  +--+--+--+--+  +  +  +--+  +--+--+  +--+--+  +--+  +  +--+--+  |
|     |        |  |        |     |           |  |        |  |        |  |  |  |        |        |     |  |  |  |  |  |     |     |        |        |  |
+--+  +  +--+  +  +--+  +  +  +--+  +--+--+--+  +  +--+  +  +--+--+--+  +--+  +  +--+--+  +--+  +  +--+  +  +  +  +  +  +--+--+  +--+--+--+--+--+  +  |
|     |  |     |        |  |     |  |        |     |     |  |        |        |           |     |     |  |  |        |     |     |           |     |  |
|  +--+  +--+--+--+--+--+  +  +  +--+  +-----+--+  +--+--+  |  |  ---+--+--+--+--+--+--+--+--+--+  +  +  +  +--+--+--+--+  +  +--+  +--+--+--+  +--+  |
|     |           |        |  |        |     |  |           |  |     |     |     |           |     |  |     |        |     |  |     |           |     |
+--+  +--+--+--+  +  +--+--+--+--+--+--+  +  +  +  ------+--+--+--+  |  ---+  |  +  +--+--+  +--+  +  +  +--+  +--+  +  +  +  +  +  +  +--+--+--+  +  |
|  |        |           |           |     |  |           |        |  |        |     |     |     |  |     |     |     |  |     |  |     |           |  |
|  +--+--+  +--+--+  +  +  +--+--+  +  +--+  +-----------+  +--+  +  +--------+  +--+  +  +--+  +  +--+--+  +--+  +--+  +--+--+--+--+  +  +--+--+--+--+
|     |     |        |     |        |  |     |           |     |  |  |           |     |     |  |  |     |  |     |     |           |                 |
|  +  +  +  +  +--+--+--+--+  +--+  +  |  +--+  +--+--+  +--+  +  +  +--+--+--+--+  +--+  +--+  +  +  +--+  +  +--+  +--+  +--+--+  +--+--+--+--+--+  |
|  |  |  |     |  |     |     |        |  |     |  |     |     |  |        |     |     |     |  |  |        |     |        |        |                 |
+--+  +--+--+--+  +  +  +  +--+--------+  +  +--+  |  |  |  ---+  +-----+  +  +  +--+  +--+  +  +  +  +--+  +  +--+--+--+--+--+--+--+  +--+--+--+--+--+
|           |     |  |        |           |  |  |     |  |     |  |     |  |  |     |     |     |     |     |  |           |        |        |        |
|  +--+--+  +--+  +  +--+--+--+  +--+--+--+  +  +--+--+--+--+  +  |  ----  +--+--+  +--+  +--+--+--+--+  +--+  +  +--+--+  +  +  +--+--+  +  +  +--+  |
|        |           |           |     |     |  |           |  |  |     |        |        |           |  |     |  |     |     |        |  |  |     |  |
|--+--+  +--+--+--+--+  +--+  +--+  +  +  +--+  +  +--+--+  +  +  |  |  +--+  +--+--+  +  +  +  +--+  +  +  +--+  +  +  +--+--+  +--+  +  +--+--+  +  |
|     |  |        |  |  |     |     |  |        |     |     |  |  |  |     |  |        |  |  |     |  |  |        |  |  |        |     |  |     |  |  |
|  +  +  +  +--+  +  +  +--+  +  +--+  +  +--+--+  +--+  +--+  +  |  |  +--+  +  +--+--+  +  +--+  +--+  +--+--+  +  +--+  +--+--+  +--+  +  +  +  +  |
|  |     |  |  |     |     |  |  |        |        |     |     |  |  |        |     |     |     |     |  |     |     |     |     |     |     |  |  |  |
|  +--+--+  +  +--+  +--+  +  +--+  +--+--+  +--+--+  +--+  +--+  |  +--+--+--+--+  +  +--+--+  +--+  +  +  +  +--+--+  +--+  +--+--+  +--+  +--+  +  |
|     |     |        |     |        |        |        |  |  |  |  |              |  |        |     |     |  |        |  |  |  |        |  |     |  |  |
+--+  +  +--+--+--+  |  +--+--+  +--+  +--+--+  +--+--+  +  +  +  +--+--+  +--+  +  +--+--+  +--+  +--+--+  +  +--+  +  +  +  +  +--+  +  +--+  +  +--+
|     |        |     |  |     |        |     |     |        |  |  |     |     |     |     |  |     |     |  |     |     |     |     |  |        |     |
|  +--+--+--+  |  +--+  +  +  +--+  +--+--+  +--+  +  +--+--+  +  |  +--+  +  +--+--+  +  +  +  +--+  +  +  +--+  +--+--+  +--+--+  +  +--+--+--+  +  |
|  |           |  |  |  |  |     |  |           |  |           |        |  |  |        |  |  |  |     |     |  |     |  |     |     |        |     |  |
|  +  +--+--+--+  +  |  |  +--+  +  +  +--+--+--+  +--+--+--+--+  |  |  +--+  +  +--+--+  +--+  |  +--+-----+  +--+  +  +--+  +  +--+--+--+  +--+--+  |
|  |     |     |  |     |  |        |  |     |     |        |     |  |  |     |  |     |     |  |  |        |  |  |  |  |        |     |     |     |  |
|  +---  |  |  |  +-----+  |  |  ---+  |  |  +  ---+  +  ---+  +--+  |  |  ---+  +  +--+  +  |  |  +-----+  +  +  +  +  +--+--+--+  +  +  +  +  +  +  |
|        |  |     |        |  |           |  |        |        |     |           |        |     |           |        |              |     |     |    #|
+--------+--+-----+--------+--+-----------+--+--------+--------+-----+-----------+--------+-----+-----------+--------+--------------+-----+-----+-----+
